{
  "x_start": -3,
  "y_start": -3,
  "resolution": 0.5,
  "grid": [
    [0,0,0,0,0,0,0,0,0,0,0,0,0],
    [0,0,0,0,0,1,0,1,0,0,0,0,0],
    [0,0,0,1,1,1,1,1,1,1,0,0,0],
    [0,0,0,1,1,1,1,1,1,1,0,0,0],
    [0,1,1,1,0,1,0,1,0,1,1,1,0],
    [0,1,1,1,1,1,1,1,1,1,1,1,0],
    [0,1,1,1,0,1,0,1,0,1,1,1,0],
    [0,1,1,1,1,1,1,1,1,1,1,1,0],
    [0,1,1,1,0,1,0,1,0,1,1,1,0],
    [0,0,0,1,1,1,1,1,1,1,0,0,0],
    [0,0,0,1,1,1,1,1,1,1,0,0,0],
    [0,0,0,0,0,1,1,1,0,0,0,0,0],
    [0,0,0,0,0,0,0,0,0,0,0,0,0]
  ]
}


